*	name	Klett Green Line 3 Vokabeln
*	description	Vokabeln aus Green Line 3
*	author	Lena Abeling
*	tsv	true
Text 1	Text 2	
oval	oval,eiförmig	
pitch	Spielfeld,Platz	
referee	Schiedsrichter	
to control	kontrollieren	
baseball	Baseball	
ice	Eis	
stick	Stock,Schläger	
Base	Base (beim baseball)	
field	feld	
bat	Schläger(Tischtennis,Baseball)	
cricket	Kricket	
to go on	(an)dauern	
athletics	Leichtathletik	
rugby	Rugby	
track	Bahn,Weg	
skateboarding	Skateboard fahren	
American	amerikanisch	
helmet	Helm	
racket	Schläger	
umpire	Schiedsrichter	
court	Spielfeld	
ice hockey	Eishockey	
race	Wettlauf, Rennen	
brake	Bremse	
event	Ereignis, Veranstaltungen	
chance	Chance	
arrangements	Abmachungen,Vereinbarungen, Plan	
feeling	Gefühl	
not until 	erst (dann) , wenn	
to offer	(an)bieten	
to open	eröffnen	
situation	Situation	
talkwise	redegewandt	
agreeing	Zustimmen	
disagreeing	Widersprechen 	
wheelchair	Rollstuhl	
once	einmal	
to agree	zustimmen	
exactly	genau	
rubbish	Unsinn, Quatsch, Müll	
luck	Glück	
relative clause	Relativsatz	
which	der, dem,den,die,das	
American Football	American Football	
half pl. Halves	die Hälfte, Halbzeit	
channel	Kanal, Programm	
that	der,dem,den,die,das	
commercial break	Werbepause	
commercial	Werbespot	
who	der,dem,den,die	
also	auch	
unusual	ungewöhnlich	
bobsleigh	Bob	
snow	Schnee	
whose	Dessen,deren	
rowing	Rudern	
the lungs	die Lunge	
swimming	Schwimmen	
scientist	Wissenschaftler	
disabled	behindert	
athlete	Athlet	
gold medal	Goldmedaille	
record	Rekord	
marathon	Marathon	
love	null(Tennis)	
relative pronoun	Relativpronomen	
sweat	Schweiß	
oddity	Eigenartigkeit, Kuriosität	
definition	Definition	
contact clause	Relativsatz ohne RP	
exact	genau,exact	
eagle	Adler	
glasses	Brille	
ski jump	Skispringen	
ski	Ski	
jump	Sprung	
at last	Endlich	
press conference	Pressekonferenz	
to mist up	beschlagen	
goggles	Schwimmbrille	
ski jumper	Skispringer	
van	Lieferwagen	
tratidion	Tradition	
far	weit	
might	könnte(n)	
to slide,slid,slid	gleiten,rutschen	
to flap	flattern	
place	Platz	
to wave	winken	
