*	name	Klett Green Line 1 Vokabeln
*	description	Vokabeln aus Green Line 1, Ausgabe 2006, aus dem Klett-Verlag
*	author	Achim Abeling
*	tsv	true
Text 1	Text 2
Einchecken	check-in
Hallo	Hello
Ich heiße...	My name is...
Ich bin	I'am
elf	eleven
aus, von	from
in	in
ein/-e	a, an
Schüler, Schülerin	pupil
in, auf, bei, an	at
zwölf	twelve
auch	too
diese/-r/-s	this
neu	new
Jahr;Jahrgangsstufe, Klasse, Schuljahr	year
sieben	seven
klein, winzig	tiny
Maus	mouse
eins	one
und	and
Zuhause	home
Wie heißt du?	What's your name?
Wie alt bist du?	How old are you?
Woher kommst du?	Where are you from?
Wie man...	How to...
jemanden begrüßen	to say hello
sagen	to say
nützlich, hilfreich	useful
Satz, Redewendung	phrase
zehn	ten
Telefonnummer	phone number
Nummer, Hausnummer, Zahl	number
Handy, Mobiltelefon	mobile
oder	or
schreiben	to write
der, die, das	the
Pack's an!	Hands on
Ordner, Mappe	folder
anfangen, beginnen	to start
Wortsammlung	word bank
Wort	word
kennen; wissen	to know
Grundschule	primary school
mehr; weitere	more
über	about
dich selbst	yourself
Sprache	language
Leute kennen lernen, Leute treffen	meeting people
Freund, Freundin	friend
aber	but
es ist	it's
groß	big
hier ist	here's
er ist	he's
sie ist	she's
das ist	that's
Frau (Anrede)	Mrs
Klassenlehrer, Klassenlehrerin	tutor
Deutschlehrer	German teacher
also, folglich, deshalb	so
du bist; ihr seid; Sie sind	you're
Klasse	tutor group
Lieblings-	favourite
Sport, Sportart	sport
Fußball	football
Tor	goal
England	England
Schuh	shoe
danke	thank you
Herr (Anrede)	Mr
Hausmeister	caretaker
beängstigend, unheimlich	scary
Beispiel	example
Mach/Macht bitte weiter.	Go on, please.
bitte	please
Spiel	game
falsch	wrong
richtig	right
Reihenfolge	order
Tipp, Ratschlag	tip
Guten Morgen.	Good morning.
Wie geht es dir/Ihnen?	How are you?
Mir geht es gut.	I'm fine.
Du bist dran.	Your turn.
lang	long
kurz	short
Form	form
bist, sind, seid	are
wir	we
Klassenzimmer	classroom
Ja, das sind wir.	Yes, we are.
ist nicht	isn't
sicher	sure
Zimmer, Raum	room
Nein, ist er nicht.	No, he isn't.
wer ist	who's
nett, sympathisch	nice
immer	always
Er kommt zu spät.	He's late.
Du hast Glück/Ihr habt Glück	You're lucky.
nicht	not
bist, sind, seid nicht	aren't (=are not)
sie (pl.)	they
Mädchen	girl
Junge	boy
Was ist los?	What's up?
Es tut mir leid.	I'm sorry.
Tasche	bag
mit	with
Buch	book
Mama	mum
Leute, Menschen	people
einsetzen	to put in
auf, an	on
Seite	page
ihr/-e	her
Tagebuch	diary
so	so
sehr	very
Grammatik	grammar
anschauen, ansehen	to look at
Bild	picture
machen, bilden	to make
Satz	sentence
Frage	question
Antwort	answer
Schulsachen	school things
Schultasche	school bag
Federmäppchen	pencil-case
Füller	pen
Bleistift	pencil
Radiergummi	rubber
Lineal	ruler
Heft	exercise book
Apfel	apple
abschreiben, abmalen	to copy
Raster, Tabelle	grid
heraushören	to listen for
ausfüllen	to fill in
Laut	sound
Liste	list
spielen	to play
zwei	two
drei	three
vier	four
fünf	five
sechs	six
sieben	seven
acht	eight
neun	nine
zehn	ten
elf	eleven
zwölf	twelve
dreizehn	thirteen
vierzehn	fourteen
fünfzehn	fifteen
sechszehn	sixteen
siebzehn	seventeen
achtzehn	eighteen (! nur ein t)
neunzehn	nineteen
zwanzig	twenty
einundzwanzig	twenty-one
dreißig	thirty
vierzig	forty (! ohne u)
fünfzig	fifty
sechzig	sixty
siebzig	seventy
achtzig	eighty
neunzig	ninety
hundert	one hundred
Plural, Mehrzahl	plural
Alphabet	alphabet
klatschen	to clap
Unterrichtsstunde	lesson
rufen, schreien	to shout
machen, tun	to do
buchstabieren	to spell
Wörter, die du aus der Grundschule kennst	words that you know from primary school
Worträtsel	word puzzle
Buchstabe	letter
Fenster	window
Stuhl	chair
Tafel, Brett	board
Poster	poster
Tür	door
Wand, Mauer	wall
Tisch	table
Schrank	cupboard
Schreibtisch	desk
da ist, es gibt	there's
da sind, es gibt	there are
Kartoffelchip	crisp
unter	under
hinter	behind
Schokolade	chocolate
in, im	in
anrufen	to phone
vor	in front of
benutzen, nutzen	to use
Sätze für den Unterricht	classroom phrases
auf Englisch	in English (! großes E)
Tut mir leid, dass ich zu spät komme.	Sorry I'm late.
Was haben wir als Hausaufgabe auf, bitte?	What's for homework, please?
Kann ich bitte zur Toilette gehen?	Can I go to the toilet, please?
Setz dich/Setzt euch bitte.	Sit down, please.
Nichts zu danken/Gern geschehen	You're welcome.
auf Wiedersehen	goodbye
tschüss	bye
jetzt, nun, gerade	now
Rollenspiel	role play
spielen (eine Rolle)	to act
Dialog	dialogue
Text	text
kein/-e	no
Problem	problem
Restaurant, Kantine	eatery
Mittagszeit, Mittagspause	lunchtime
Cafeteria	cafeteria
Schau mal!/Sieh mal!	Look!
Witz	joke
Buchstabe	letter
leicht, einfach	easy
langweilig	boring
schrecklich, schlimm, furchtbar	terrible
Schulhof, Spielplatz	playground
sie ist gut in/bei...	she is good at...
aufpassen	to watch out
Ball	ball
Baum	tree
Gruppe	group
vervollständigen	to complete
stellen, setzen, legen	to put
sie|(Dativ)	them
höflich	polite
du hast Unrecht/du irrst dich	you're wrong
böse, gemein	nasty
wortschlau, wortgewandt	wordwise
Wortnetz	word web
Vokabular, Wortschatz	vocabulary
Fertigkeit	skill
finden	to find
gut	good
Adjektiv, Eigenschaftswort	adjective
andere/-r/-s|weitere/-r/-s	other
Auschecken	check-out
Was fehlt?	What is missing?
anders, unterschiedlich	different
trautes Heim/(Sprichwort)	home sweet home
süß	sweet
violett, lila	purple
grau	grey
grün	green
schwarz	black
weiß	white
rosa, pink	pink
rot	red
blau	blue
orange	orange
braun	brown
gelb	yellow
Karte, Spielkarte	card
pro	per
hochhalten	to hold up
richtig	correct
Farbe	colour
geöffnet, offen, aufgeschlagen	open
fragen	to ask
dann, danach	then
schließen, zumachen	to close
(be)antworten	to answer
Küche	kitchen
Wohnzimmer	living room
Bad(ezimmer)	bathroom
Schlafzimmer	bedroom
Reim	rhyme
Bett	bed
Sofa, Couch	sofa
lustig, witzig	funny
Haus	house
Fernseher	TV
auswendig lernen	to learn by heart
beschreiben	to describe
so, auf diese Weise	like this
Möbel	furniture
Traum	dream
sprechen (mit)/reden (mit)	to talk (to)
zeichnen	to draw
sein/-e	his
Familie	family
Mutter	mother
Großvater	grandfather
Opa	grandad
Bruder	brother
Schwester	sister
Vater	father
Papa, Vati	dad
Großmutter	grandmother
Oma	Grandma
glücklich, fröhlich	happy
Welche Farbe haben ...?	What colour are ...?
zu Hause	at home
Eltern	parents
Halbschwester	half-sister
Stiefvater	step-father
unser/-e	our
Wohnung	flat
Straße	road
über	over
Computerladen	computer shop
Geschäft, Laden	shop
sein	its
klein	small
Nasreen und ich sind ...	Nasreen and I are ...
Einzelkind	only child
Kind	child pl. children
Katze	cat
Tiger	tiger
nur	only
interessiert an	interested in
Mäuse	mice
Garten	garden
Schuppen, Gartenhäuschen	shed
Schlagzeug	drums
Chemiekasten	chemistry set
zuordnen	to match
Hund	dog
Foto	photo
jemandem zuhören	to listen to
warum	why
oben, im Obergeschoss	upstairs
unten, im Untergeschoss	downstairs
Nationalität	nationality
Familienstammbaum	family tree
verheiratet mit	married to
Tante	aunt
Onkel	uncle
geschieden von	divorced from
Cousin, Cousine	cousin
Mittagessen	lunch
Minute	minute
neben	next to
auf der linken Seite, links	on the left
auf der rechten Seite, rechts	on the right
europäisch, aus Europa	European
polnisch, aus Polen; Polnisch	Polish
weil, da	because
Polen	Poland
englisch, aus England	English
griechisch, aus Griechenland; Griechisch	Greek
heute	today
italienisch, aus Italien; Italienisch	Italian
euer; eure; Ihr(e)	your
ihr, ihre (Plural)	their
erzählen, sagen	to tell
Deutschland	Germany
Russland	Russia
russisch, aus Russland; Russisch	Russian
Griechenland	Greece
Italien	Italy
Türkei	Turkey
türkisch, aus der Türkei; Türkisch	Turkish
Spanien	Spain
spanisch, aus Spanien; Spanisch	Spanish
